7222222222222222222222228
9U00000000000000000000019
9000000000000000000000019
9000000000000000000000U19
9000000000000000000000019
9000000000000000000000019
9000000100000000000000019
9032222400000000000010019
9000000000000000000010019
9000000000000003222224019
9000000000000003224000019
9003224000000000000000019
9000000000000322222224019
9U00000@00000000000000U19
6222222222222222222222225