@000000000000000000200000
0000022200000000010201211
1010000000000000000200000
0000000000000000000200000
0000000000000000000200000
0000000000000000000200000
1111111111111111111111111