0000000000000000000000000
0000000000000000000000000
0000000000000000000000000
0111000000000000000001110
0000011111111111111100000
0000000000000000000000000
0000000000000000000000000
0000000000000000000000000
0000000000000000000000000
0000000000000000000000000
0000000000000000000000000
0000000000000000000000000
0090000111111111110000000
1110000000000000000000111
0000000000101000000000000
0001111111111111111111000
0000000000000000000000000