7222222222222222222222228
90U0U0U000000000000000009
9000000000000000000000009
9000000000000000000000009
9000000003222400000000009
9000000000000000000000009
9010000000000000000000009
9032222400000000000000009
900000000000000U00U0U0009
9000000000000003222224009
9000000000000000000000009
9000322240000000000000009
9000000000000000000000009
9100000@00000000011000009
6222222222222222222222225