7222222222222222222222228
9U0U0U0U0U0U0U0U0U0U0U0U9
9000000000000000000000009
9U0U00000000000000000U0U9
9003222222240000000000009
9000000000000000000000009
9000000000000100000000009
9000000000322224000000009
9000000000000000000000009
9000000000000000000000009
9100000000000000000032249
9322400000000000000000009
9000000000000000010000009
9000000@00000001110000009
6222222222222222222222225